Translations of terms:

* noun: существительное (abbr: сущ.)
* adjective: прилагательное (abbr: прил.)
* verb: глагол (abbr: гл.)
* pre-verb: вспомогательный глагол (abbr: вспом. гл.)
* particle: частица (abbr: част.)
* number: число (abbr: числ.)

* a or kin: (акцентирование внимания, эмоция или подтверждение)
* akesi: некрасивое животное; рептилия, амфибия
* ala: нет, не-, ноль
* alasa: охотиться, добывать продовольствие
* ale or ali: (adj) всё; обильный, бессчётный, предостаточный, каждый / (noun) изобилие, всё, жизнь, вселенная / (num) 100
* anpa: поклоняющийся, нисходящий, скромный, низкий, зависимый
* ante: другой, изменённый
* anu: или
* awen: стойкий, хранимый, защищённый, безопасный, ждущий, оставшийся / (pv) продолжить (что-то делать)
* e: (до прямого дополнения)
* en: (между несколькими подлежащими)
* esun: рынок, магазин, базар, деловая транзакция
* ijo: вещь, феномен, объект, материя
* ike: плохой, негативный; необязательный, ненужный
* ilo: инструмент, средство, машина, устройство
* insa: центр, содержимое, внутренность, между; внутренний орган, желудок
* jaki: отвратительный, непристойный, болезненный, ядовитый, грязный, несанитарный
* jan: человек, личность, кто-то
* jelo: жёлтый, желтоватый
* jo: иметь, нести, содержать, держать
* kala: рыба, водное животное, морское существо
* kalama: производить звуки; читать вслух
* kama: (adj) прибывающий, приходящий, будущий, призванный / (pv) стать, суметь, добиться успеха
* kasi: растения, зелень; трава, лист
* ken: (pv) иметь возможность, иметь право / (adj) возможный
* kepeken: использовать, с, при помощи
* kili: фрукт, овощ, гриб
* kiwen: твёрдый объект, металл, камень
* ko: глина, липкая форма, тесто, полутвёрдая материя, паста, порошок
* kon: воздух, дыхание; сущность, дух; скрытая сущность, невидимая сила
* kule: цветной, крашеный
* kulupu: сообщество, компания, группа, нация, общество, племя
* kute: (n) ухо / (v) слушать, слышать; обращать внимание, подчиняться
* la: (между контекстом и основным предложением)
* lape: спящий, отдыхающий
* laso: синий, зелёный
* lawa: (n) голова, ум / (v) управлять, указывать, вести, править, владеть, планировать, регулировать
* len: ткань, одежда, текстиль; прикрытие, 


